# # # # # # # # # # # # # # # #
# L . . . # A A # . . . . . * #
# . . . . # # # # . . . . . . #
# . . . . . . . . . . B . . . #
# # # # # # # # # . . . U . . #
# L L . . . . . . . . B . . G #
# # # # # # # # # . . . . . . #
# . . . . . . . . . . B . . . #
# . # # # # # # # . . . . . . #
# . . . . . . L # . . . . . * #
# # # # # # # # # # # # # # # #