# # # # # # # # # # # # # # # #
# * . . . . . . * # . . . # L #
# . . . . . . . . # . # . # L #
# . . . . . B . . # . # . # L #
# . . . . . . . . # . # . # L #
# G . . B . U . I . . # . # L #
# . . . . . . . . # # # . # L #
# . . . . . B . . # . . . # I #
# . . . . . . . . # . # # # . #
# * . . . . . . * # . . . . . #
# # # # # # # # # # # # # # # #