# # # # # # # # # # # # # # # #
# L . . # . . . . . . . . G . #
# L . . # # . . . . . . . . . #
# L . . . . . . . . . . # # # #
# L . . # # . . . . B . . . . #
# L . . # . . . . . . . # # . #
# L . . # . B . . . . . . # . #
# L . . # . . . . . . . . # . #
# L . . # . U . . . . . . # . #
# L . . # . . . . . . . . # L #
# # # # # # # # # # # # # # # #