# # # # # # # # # # # # # # # #
# . . . . . . . . # # # # # # #
# . U . . . . . . . . . . . G #
# . . . . . . . . # # # # # # #
# . . . . . . . . # . . . . . #
# # . . . . . . . # . . L . . #
# # # . L . . . . # . . . . . #
# # # # # # # # # # # # # # # #