# # # # # # # # # # # # # # # #
# . . . . . . # * . . . . . * #
# . . . . . . # . . . . . . . #
# . . . G . . # . . . . . # 32 #
# . . . . . # L # . . . . # L #
# . B . U . 15 15 15 . . . B . 34 #
# . . . . . # A # . . . . # A #
# . . . . . . 11 # . . . . # # #
# . . . . . . . # . . . . 40 L #
# . . . . . . # # * . . . 40 L #
# # # # # # # # # # # # # # # #
