# # # # # # # # # # # # # # # #
# A # . . . . . . . . . # # * #
# # # . . . . . . . . . . # 50 #
# . . . . . . . . . . . . . . #
# . . . . . # 14 # 24 # 46 # . . #
# . U . B . # L # L # L # . G #
# . . . . . # 12 # 26 # 48 # . . #
# . . . . . . . . . . . . . . #
# # # . . . . . . . . . . # 50 #
# A # . . . . . . . . . . # * #
# # # # # # # # # # # # # # # #