A . # . . . . . . . . . . .
. . # . . . . B . . . . * .
# # # . . . . . . . . . . .
. . . . . # # # # # . . # #
. G . U . 30 L # L 14 . . # #
. . . . . # # # # # . . # #
# # # . . . . . . . . . . .
. . # . . . . B . . . . * .
A . # . . . . . . . . . . .