# # # # # # # # # # # # # # # #
# . . . . . . . . . . L . . . #
# . . . . . . # # # # # # # # #
# . . . . . . . . . . . . # G #
# . . . . . . . . . . . . . . #
# . . . . . . . . . . . . . . #
# . . . . . B . . . . . . . . #
# . . . # # A # # . . . . . . #
# . U . # A A A # . . . . . . #
# . . . # A A A # . . . . . . #
# # # # # # # # # # # # # # # #