# # # # # # # # # # # # # # # #
# . . . . . . . . . . . . . A #
# . . . . . . . . . . . G . . #
# . . . . . . . . . . . . . . #
# . . . . . . . . . . . . . . #
# . . . . . . . . . . . . . . #
# . . . . . . . . . . . . . . #
# . . . . . . . . . . . . . . #
# . . U . . . . . . . . . . . #
# L . . . . . . . . . . . . . #
# # # # # # # # # # # # # # # #