# # # # # # # # # # # # # # # #
# . . . # . . . . . . . # A # #
# . G . # . . . . . B . # 13 # #
# . . . # . . . . . . . . . . #
# . # # # # I . . . . . . . . #
# . 34 L 28 . . . 28 . . U . . . #
# . # # # # I . . . . . . . . #
# . . . # # . . . . . . . . . #
# . . . 34 . . . . . B . . . . #
# . . . # . . . . . . . . . . #
# # # # # # # # # # # # # # # #