# # # # # # # # # # # # # # # #
# . . . . . . . . . . . . . . #
# . # # # # # . . # # # # # . #
# . . . . L B . . B L . . . . #
# # B # # # # . . # # # # B # #
# . . # # # # . . # # # # . . #
# * . # . . # U . # . . # . G #
# # # # . B . . . . B . # # # #
# . . # . . . . . . . . # . . #
# A . # . . . . . . . . # . A #
# # # # # # # # # # # # # # # #