# # # # # # # # # # # # # # # #
# . . . . . . G . . . . . # # #
# . * . . . . . . . . . . . # #
# . . . . . . . . . . . . . . #
# . . . . . . B . . . . . . . #
# . U . . . B A B . . . . . L #
# . . . . . . B . . . . . . . #
# . . . . . . . . . . . . . . #
# . * . . . . . . . . . . . # #
# . . . . . . . . . . . . # # #
# # # # # # # # # # # # # # # #