# # # # # # # # # # # # # # # #
# . . . . . . . . . . . . # # #
# . # B # # # # # # # . . . . #
# . # . . # . . . . # . . . . #
# . # . . # . U . . # . . . . #
# . # G . # . . . . # . . . . #
# . # # # # . B . . # # # B # #
# . # L . # . . . . . . . . . #
# . # # . # # # # # # # # # . #
# . . . . . . . . . . . . # L #
# # # # # # # # # # # # # # # #