# # # # # # # # # # # # # # # #
# L . . . . . . . . . . . # A #
# # # # # # # # # . U . . # # #
# L # . . . . . . . B . . . # #
# . # . . . . . . . . . . . # #
# . # . * . . . . . B . G . # #
# . # . . . . . . . . . . . # #
# . # . . . . . . . . . . . # #
# . # # # # # # # # . . . # # #
# . . . . . . . . . . . . # A #
# # # # # # # # # # # # # # # #